+++++++++++++++++++
+0  +          dcb+
+      B       ++++
+ D               +
+A    C        ++ +
+               +a+
+++++++++++++++++++
