+++++++++++++++++
+               +
+ 0A  a         +
+               +
+               +
+               +
+               +
+++++++++++++++++
