++++++++++
+    +   +
+ 0  A    +
+       ++
++      +
+        +
+   ++ +a+
++++++++++